0407014650
Forest-
RRRRRRRRRRRRRRRRRRRRRRRRRRRRRRRRRRRRRRRRRRRRRRRRRRRRRRRRRRRRRRRRRRRRRRRRRRRRRRRRRRRRRRRRRRRRRRRRRRRR
R               |                  |        P         |             |          W         |         R
R               |                  |                  |             |                    |         R
R               |                  |                  |             |                    |         R
R               |                  |                  |             |                    |         R
R               |                  |                  |             |                    |         R
R               |                  |                  |             |                    |         R
R               |                  |                  |             |                    |         R
R               |                  |                  |             |                    |         R
R_____   _______|                  |_______   ________|             |________  __________|         R
R                                                                                                  R
R                                                                                                  R
R                                                                                                  R
R                                                                                                  R
R                                                                                                  R
R                                                                                                  R
R                                                                                                  R
R                                                                                                  R
R                                                                                                  R
R                                                                                                  R
R________  _________          _______  _______           _______  _______           _______________R
R                  |          |              |           |              |           |              R
R                  |          |              |           |              |           |              R
R                  |          |              |           |              |           |              R
R                  |          |              |           |              |           |              R
R                  |          |              |           |              |                          R
R   C              |          |     G        |           |    H         |                          R
R                  |          |              |           |              |           |              R
R                  |          |              |           |              |           |              R
R                  |          |              |           |              |           |              R
R                  |          |              |           |              |           |              R
R______  __________|          |______  ______|           |______  ______|           |______________R
R                                                                                                  R
R                                                                                                  R
R                                                                                                  R
R                                                                                                  R
R                                                                                                  R
R                                                                                                  R
R                                                                                                  R
R                                                                                                  R
R                                                                                                  R
R                                                                                                  R
R                                                                                                  R
R                                                                                                  R
R                                                                                                  R
R                                                                                                  R
RBBBBBB          BBBBBBBBBBBBBBBBBBBBBBBBBB    BBBBBBBBBBBBBBBBBBBBBBBBBBBBBBB        BBBBBBBBBBBBBR
RBBBBBBYYYYYYYYYYBBBBBBBBBBBBBBBBBBBBBBBBBBYYYYBBBBBBBBBBBBBBBBBBBBBBBBBBBBBBBYYYYYYYYBBBBBBBBBBBBBR
RYYYYYYYYYYYYYYYYYYYYYYYYYBBYYYYYYYYYYYYYYYYYYYYYYYYYYYYYYYYYYYYBBYYYYYYYYYYYYYYYYYYYYYYYYYYYYYYYYYR
RYYYYYYYYYYYYYYYYYYYYYYYYYBBYYYYYYYYYYYYYYYYYYYYYYYYYYYYYYYYYYYYBBYYYYYYYYYYYYYYYYYYYYYYYYYYYYYYYYYR
RYYYYYYYYYYYYYYYYYYYYYYYYYBBYYYYYYYYYYYYYYYYYYYYYYYYYYYYYYYYYYYYBBYYYYYYYYYYYYYYYYYYYYYYYYYYYYYYYYYR
RYYYYYYYYYYYYYYYYYYYYYYYYYBBYYYYYYYYYYYYYYYYYYYYYYYYYYYYYYYYYYYYBBYYYYYYYYYYYYYYYYYYYYYYYYYYYYYYYYYR
RYYYYYYYYYYYYYYYYYYYYYYYYYYYYYYYYYYYYYYYYYYYYYYYYYYYYYYYYYYYYYYYYYYYYYYYYYYYYYYYYYYYYYYYYYYYYYYYYYYR
RYYYYYYYYYYYYYYYYYYYYYYYYYYYYYYYYYYYYYYYYYYYYYYYYYYYYYYYYYYYYYYYYYYYYYYYYYYYYYYYYYYYYYYYYYYYYYYYYYYR
RYYYYYYYYYYYYYYYYYYYYYYYYYBBYYYYYYYYYYYYYYYYYYYYYYYYYYYYYYYYYYYYBBYYYYYYYYYYYYYYYYYYYYYYYYYYYYYYYYYR
RYYYYYYYYYYYYYYYYYYYYYYYYYBBYYYYYYYYYYYYYYYYYYYYYYYYYYYYYYYYYYYYBBYYYYYYYYYYYYYYYYYYYYYYYYYYYYYYYYYR
RYYYYYYYYYYYYYYYYYYYYYYYYYBBBBBBBBBBBBBBBBBBYYYYBBBBBBBBBBBBBBBBBBYYYYYYYYYYYYYYYYYYYYYYYYYYYYYYYYYR
RYYYYYYYYYYYYYYYYYYYYYYYYYBBBBBBBBBBBBBBBBBBYYYYBBBBBBBBBBBBBBBBBBYYYYYYYYYYYYYYYYYYYYYYYYYYYYYYYYYR
RYYYYYYYYYYYYYYYYYYYYYYYYYBBYYYYYYYYYYYYYYYYYYYYYYYYYYYYYYYYYYYYBBYYYYYYYYYYYYYYYYYYYYYYYYYYYYYYYYYR
RYYYYYYYYYYYYYYYYYYYYYYYYYBBYYYYYYYYYYYYYYYYYYYYYYYYYYYYYYYYYYYYBBYYYYYYYYYYYYYYYYYYYYYYYYYYYYYYYYYR
RYYYYYYYYYYYYYYYYYYYYYYYYYBBYYYYYYYYYYYYYYYYYYYYYYYYYYYYYYYYYYYYBBYYYYYYYYYYYYYYYYYYYYYYYYYYYYYYYYYR
RYYYYYYYYYYYYYYYYYYYYYYYYYBBYYYYYYYYYYYYYYYYYYYYYYYYYYYYYYYYYYYYBBYYYYYYYYYYYYYYYYYYYYYYYYYYYYYYYYYR
RYYYYYYYYYYYYYYYYYYYYYYYYYBBYYYYYYYYYYYYYYYYYYYYYYYYYYYYYYYYYYYYBBYYYYYYYYYYYYYYYYYYYYYYYYYYYYYYYYYR
RYYYYYYYYYYYYYYYYYYYYYYYYYBBYYYYYYYYYYYYYYYYYYYYYYYYYYYYYYYYYYYYBBYYYYYYYYYYYYYYYYYYYYYYYYYYYYYYYYYR
RYYYYYYYYYYYYYYYYYYYYYYYYYBBYYYYYYYYYYYYYYYYYYYYYYYYYYYYYYYYYYYYBBBBBBBBBBBBBBBBYYYYYYYYBBBBBBBBBBBR
RYYYYYYYYYYYYYYYYYYYYYYYYYBBYYYYYYYYYYYYYYYYYYYYYYYYYYYYYYYYYYYYBBBBBBBBBBBBBBBBYYYYYYYYBBBBBBBBBBBR
RYYYYYYYYYYYYYYYYYYYYYYYYYBBYYYYYYYYYYYYYYYYYYYYYYYYYYYYYYYYYYYYYYBBYYYYYYYYYYYYYYYYYYYYYYYYYYYYYYYR
RBBBBBBYYYYYYYYYYBBBBBBBBBBBYYYYYYYYYYYYYYYYYYYYYYYYYYYYYYYYYYYYYYBBYYYYYYYYYYYYYYYYYYYYYYYYYYYYYYYR
RBBBBBBYYYYYYYYYYBBBBBBBBBBBYYYYYYYYYYYYYYYYYYYYYYYYYYYYYYYYYYYYYYBBYYYYYYYYYYYYYYYYYYYYYYYYYYYYYYYR
RYYYYYYYYYYYYYYYYYYYYYYYYYYYYYYYYYYYYYYYYYYYYYYYYYYYYYYYYYYYYYYYYYBBYYYYYYYYYYYYYYYYYYYYYYYYYYYYYYYR
RYYYYYYYYYYYYYYYYYYYYYYYYYYYYYYYYYYYYYYYYYYYYYYYYYYYYYYYYYYYYYYYYYBBYYYYYYYYYYYYYYYYYYYYYYYYYYYYYYYR
RYYYYYYYYYYYYYYYYYYYYYYYYYYYYYYYYYYYYYYYYYBBBBBBBYYYYYYYBBBBBBBBBBBBYYYYYYYYYYYYYYYYYYYYYYYYYYYYYYYR
RYYYYYYYYYYYYYYYYYYYYYYYYYYYYYYYYYYYYYYYYYBBBBBBBYYYYYYYBBBBBBBBBBBBYYYYYYYYYYYYYYYYYYYYYYYYYYYYYYYR
RYYYYYYYYYYYYYYYYYYYYYYYYYYYYYYYYYYYYYYYYYBBYYYYYYYYYYYYYYYYYYYYYYBBYYYYYYYYYYYYYYYYYYYYYYYYYYYYYYYR
RYYYYYYYYYYYYYYYYYYYYYYYYYYYYYYYYYYYYYYYYYBBYYYYYYYYYYYYYYYYYYYYYYBBYYYYYYYYYYYYYYYYYYYYYYYYYYYYYYYR
RYYYYYYYYYYYYYYYYYYYYYYYYYYYYYYYYYYYYYYYYYBBYYYYYYYYYYYYYYYYYYYYYYYYYYYYYYYYYYYYYYYYYYYYYYYYYYYYYYYR
RBBBBBBBBBBBBBBBBBBBBBBBBBBBYYYYYBBBBBBBBBBBYYYYYYYYYYYYYYYYYYYYYYYYYYYYYYYYYYYYYYYYYYYYYYYYYYYYYYYR
RBBBBBBBBBBBBBBBBBBBBBBBBBBBYYYYYBBBBBBBBBBBYYYYYYYYYYYYYYYYYYYYYYYYYYYYYYYYYYYYYYYYYYYYYYYYYYYYYYYR
RYYYYYYYYYYYYYYYYYYYYYYYYYYYYYYYYYYYYYYYYYBBYYYYYYYYYYYYYYYYYYYYYYYYYYYYYYYYYYYYYYYYYYYYYYYYYYYYYYYR
RYYYYYYYYYYYYYYYYYYYYYYYYYYYYYYYYYYYYYYYYYBBYYYYYYYYYYYYYYBBBBBBBBBBBBBBBBBBBBBBBBBBBBBBBBBBBBBBBBBR
RYYYYYYYYYYYYYYYYYYYYYYYYYYYYYYYYYYYYYYYYYBBYYYYYYYYYYYYYYBBBBBBBBBBBBBBBBBBBBBBBBBBBBBBBBBBBBBBBBBR
RYYYYYYYYYYYYYYYYYYYYYYYYYYYYYYYYYYYYYYYYYBBYYYYYYYYYYYYYYBBYYYYYYYYYYYYYYYYYYYYYYYYYYYYYYYYYYYYYYYR
RYYYYYYYYYYYYYYYYYYYYYYYYYYYYYYYYYYYYYYYYYBBYYYYYYYYYYYYYYBBYYYYYYYYYYYYYYYYYYYYYYYYYYYYYYYYYYYYYYYR
RYYYYYYYYYYYYYYYYYYYYYYYYYYYYYYYYYYYYYYYYYBBYYYYYYYYYYYYYYBBYYYYYYYYYYYYYYYYYYYYYYYYYYYYYYYYYYYYYYYR
RYYYYYYYYYYYYYYYYYYYYYYYYYYYYYYYYYYYYYYYYYBBYYYYYYYYYYYYYYBBYYYYYYYYYYYYYYYYYYYYYYYYYYYYYYYYYYYYYYYR
RYYYYYYYYYYYYYYYYYYYYYYYYYYYYYYYYYYYYYYYYYBBYYYYYYYYYYYYYYYYYYYYYYYYYYYYYYYYYYYYYYYYYYYYYYYYYYYYYYYR
RYYYYYYYYYYYYYYYYYYYYYYYYYYYYYYYYYYYYYYYYYBBYYYYYYYYYYYYYYYYYYYYYYYYYYYYYYYYYYYYYYYYYYYYYYYYYYYYYYYR
RBBBBBBBYYYYBBBBBBBBBBBBYYYYYYYYYYYYYYYYYYBBYYYYYYYYYYYYYYYYYYYYYYYYYYYYYYYBBBBBBBBBBBYYYYBBBBBBBBBR
RBBBBBBBYYYYBBBBBBBBBBBBYYYYYYYYYYYYYYYYYYBBYYYYYYYYYYYYYYYYYYYYYYYYYYYYYYYBBBBBBBBBBBYYYYBBBBBBBBBR
RYYYYYYYYYYYYYYYYYYYYYBBYYYYYYYYYYYYYYYYYYBBYYYYYYYYYYYYYYBBYYYYYYYYYYYYYYYBBYYYYYYYYYYYYYYYYYYYYYYR
RYYYYYYYYYYYYYYYYYYYYYBBYYYYYYYYYYYYYYYYYYBBYYYYYYYYYYYYYYBBYYYYYYYYYYYYYYYBBYYYYYYYYYYYYYYYYYYYYYYR
RYYYYYYYYYYYYYYYYYYYYYBBYYYYYYYYYYYYYYYYYYBBYYYYYYYYYYYYYYBBYYYYYYYYYYYYYYYBBYYYYYYYYYYYYYYYYYYYYYYR
RYYYYYYYYYYYYYYYYYYYYYBBYYYYYYYYYYYYYYYYYYYYYYYYYYYYYYYYYYBBYYYYYYYYYYYYYYYBBYYYYYYYYYYYYYYYYYYYYYYR
RYYYYYYYYYYYYYYYYYYYYYBBYYYYYYYYYYYYYYYYYYYYYYYYYYYYYYYYYYBBYYYYYYYYYYYYYYYBBYYYYYYYYYYYYYYYYYYYYYYR
RYYYYYYYYYYYYYYYYYYYYYBBYYYYYYYYYYYYYYYYYYYYYYYYYYYYYYYYYYBBYYYYYYYYYYYYYYYBBYYYYYYYYYYYYYYYYYYYYYYR
RYYYYYYYYYYYYYYYYYYYYYBBYYYYYYYYYYYYYYYYYYYYYYYYYYYYYYYYYYBBYYYYYYYYYYYYYYYBBYYYYYYYYYYYYYYYYYYYYYYR
RYYYYYYYYYYYYYYYYYYYYYBBYYYYYYYYYYYYYYYYYYBBYYYYYYYYYYYYYYBBYYYYYYYYYYYYYYYBBYYYYYYYYYYYYYYYYYYYYYYR
RYYYYYYYYYYYYYYYYYYYYYBBYYYYYYYYYYYYYYYYYYBBYYYYYYYYYYYYYYBBYYYYYYYYYYYYYYYBBYYYYYYYYYYYYYYYYYYYYYYR
RYYYYYYYYYYYYYYYYYYYYYBBYYYYYYYYYYYYYYYYYYBBYYYYYYYYYYYYYYBBYYYYYYYYYYYYYYYBBYYYYYYYYYYYYYYYYYYYYYYR
RRRRRRRRRRRRRRRRRRRRRRRRRRRRRRRRRRRRRRRRRRRRRRRRRRRRRRRRRRRRRRRRRRRRRRRRRRRRRRRRRRRRRRRRRRRRRRRRRRRR

